#####################################################################################################
#####################################################################################################
#####################################################################################################
####                                                                                           ######
####                                                                                           ######
####                                                                                           ######
####                                                                                           ######
####                                                                                           ######
####                                                                                           ######
####                                                                                           ######
####                                                                                           ######
####                                                                                           ######
####                        .....                                                              ######
####                                                                                           ######
####                                                                                           ######
####                                                                                           ######
####                                                                                           ######
####                                                                                           ######
####                                                                                           ######
####                                                                                           ######
####                                                                                           ######
####                                                                                           ######
####                                                                                           ######
####                                                                                           ######
####                                                                                           ######
####                                                                                           ######
####                                                                                           ######
#####################################################################################################
#####################################################################################################
#####################################################################################################
#####################################################################################################

