                              ###
                              ###
                              ###
                              ###
                              ###
                              ###                  ##########################################################################################
                              ###                  ##########################################################################################
                              ###
                              ###             .
                              ###             .
                              ###             .
                              ###             .    ###
                              ###             .    ###
                              ###                  ###
                              ###                  ###
                              ###                  ###
                              ###                  ###
                              ###                  ###
                              ###                  ###
                              ###                  ###
                                                   ###
                                                   ###
                                                   ###
                                                   ###
##########################################         ###
##########################################         ###
                                                   ###
                                                   ###
                                                   ###





