        #######            #######                ######                #####                  
        #######            #######                ######                #####                  
        #######            #######                ######                #####                  
        #######            #######                ######                #####                  
        #######            #######                ######                #####                  
        #######            #######                ######                #####   .               
        #######            #######                ######                #####   .               
        #######            #######                ######                #####   .               
        #######            #######                ######                #####   .               
        #######            #######                ######                #####   .               
        #######            #######                ######                #####                  
        #######            #######                ######                #####      ########
        #######            #######                ######                #####      ########
        #######            #######                ######                #####      ########
        #######            #######                ######                #####      ########
        #######            #######                ######                #####      ########
        #######            #######    ########    ######                #####      ########
####    #######            #######    ########    ######                #####      ########
####    #######            #######    ########    ######                #####      ########
####    #######            #######    ########    ######    ########    #####      ########
####    #######            #######    ########    ######    ########    #####      ########
####                                  ########              ########               ########
####              #####               ########              ########               ########
####              #####               ########              ########               ########
####              #####               ########              ########               ########
####              #####               ########              ########               ########
####              #####               ########              ########               ########
####              #####               ########              ########               ########
####              #####               ########              ########               ########
####              #####               ########              ########               ########
####              #####               ########              ########               ########
####              #####               ########              ########               ########
####              #####               ########              ########               ########
####              #####               ########              ########               ########
####              #####               ########              ########               ########
####              #####               ########              ########               ########
####              #####               ########              ########               ########
####              #####               ########              ########               ########
####              #####               ########              ########               ########
####              #####               ########              ########               ########
####              #####               ########              ########               ########
####              #####               ########              ########               ########
####              #####               ########              ########               ########

